Cantidades expresadas en euros;Fecha;Fecha valor;Concepto;Importe;Saldo Posterior
;25/08/2025;25/08/2025;PRESTAMO 0594657222;-403,1;130,73
;14/08/2025;14/08/2025;NOMINA DE: PEREZ PALACIOS MIGUEL;500;533,83
;12/08/2025;11/8/2025 12:00;APORT.REGU.PLAN-7540110541;-60;33,83
;04/08/2025;2/8/2025 12:00;PRESTAMO 0594657222;-6,17;93,83
;01/08/2025;01/08/2025;TRFI.DE:MIGUEL PEREZ PALACIOS;100;100
;25/07/2025;25/07/2025;PRESTAMO 0594657222;-396,94;0
;18/07/2025;18/07/2025;RBO. SEGUROS L-ARO;-219,82;396,94
;15/07/2025;15/07/2025;NOMINA DE: PEREZ PALACIOS MIGUEL;500;616,76
;11/07/2025;10/7/2025 12:00;APORT.REGU.PLAN-7540110541;-60;116,76